Country_Code,Country_Name,Olympic_ID,Olympic_Year,Total_No_Of_Medals,Total_No_Of_Gold_Medals,Total_No_Of_Silver_Medals,Total_No_Of_Bronze_Medals,Total_No_Of_Players_Participated,No_Of_Women_Players_Participated,No_Of_Men_Players_Participated,Male_Female_Ratio,No_Of_Players_Won,No_Of_Players_Lose
AUT,Austria-1,5,2016,0,0,0,0,2,0,2,0.0,0,2
CPV,Cape Verde,5,2016,0,0,0,0,5,3,2,0.6666666666666666,0,5
BRA,Brazil,4,2014,0,0,0,0,17,10,7,0.7,0,17
PAK,Pakistan,3,2012,0,0,0,0,21,2,19,9.5,0,21
CAY,Cayman Islands,3,2012,0,0,0,0,7,0,7,0.0,0,7
HAI,Haiti,3,2012,0,0,0,0,5,2,3,1.5,0,5
ISV,United States Virgin Islands,3,2012,0,0,0,0,9,5,4,0.8,0,9
SLE,Sierra Leone,3,2012,0,0,0,0,2,1,1,1.0,0,2
LES,Lesotho,3,2012,0,0,0,0,4,2,2,1.0,0,4
PUR,Puerto Rico,5,2016,1,1,0,0,41,28,13,0.4642857142857143,1,40
SKN,Saint Kitts and Nevis,5,2016,0,0,0,0,9,1,8,8.0,0,9
ZIM,Zimbabwe,5,2016,0,0,0,0,31,22,9,0.4090909090909091,0,31
SOL,Solomon Islands,5,2016,0,0,0,0,3,2,1,0.5,0,3
ASA,American Samoa,3,2012,0,0,0,0,4,1,3,3.0,0,4
FRA,France,2,2010,14,2,6,6,192,69,123,1.7826086956521738,14,178
THA,Thailand,5,2016,6,2,2,2,58,30,28,0.9333333333333333,6,52
IVB,British Virgin Islands,5,2016,0,0,0,0,4,3,1,0.3333333333333333,0,4
LUX,Luxembourg,5,2016,0,0,0,0,15,7,8,1.1428571428571428,0,15
POL,Poland-1,5,2016,0,0,0,0,2,0,2,0.0,0,2
KOR,South Korea-2,4,2014,0,0,0,0,6,0,6,0.0,0,6
HON,Honduras,5,2016,0,0,0,0,23,1,22,22.0,0,23
ITA,Italy-1,5,2016,2,0,2,0,2,0,2,0.0,2,0
CZE,Czech Republic,3,2012,12,4,2,6,147,70,77,1.1,12,135
BAN,Bangladesh,3,2012,0,0,0,0,7,1,6,6.0,0,7
RUS,Russia,5,2016,113,50,28,35,398,199,199,1.0,113,285
SLO,Slovenia,5,2016,4,1,2,1,70,29,41,1.4137931034482758,4,66
ESP,Spain-2,5,2016,2,2,0,0,4,2,2,1.0,2,2
AUT,Austria-2,4,2014,0,0,0,0,2,0,2,0.0,0,2
BOT,Botswana,3,2012,1,0,1,0,4,1,3,3.0,1,3
UAE,United Arab Emirates,5,2016,1,0,0,1,12,3,9,3.0,1,11
NZL,New Zealand,4,2014,0,0,0,0,18,8,10,1.25,0,18
ZIM,Zimbabwe,4,2014,0,0,0,0,2,0,2,0.0,0,2
ESA,El Salvador,3,2012,0,0,0,0,11,6,5,0.8333333333333334,0,11
GBR,Great Britain-1,2,2010,0,0,0,0,6,3,3,1.0,0,6
BUL,Bulgaria,5,2016,7,0,1,6,58,25,33,1.32,7,51
BIH,Bosnia and Herzegovina,3,2012,0,0,0,0,8,2,6,3.0,0,8
LIE,Liechtenstein,3,2012,0,0,0,0,4,3,1,0.3333333333333333,0,4
CZE,Czech Republic,5,2016,13,1,2,10,131,52,79,1.5192307692307692,13,118
ZAM,Zambia,5,2016,0,0,0,0,7,2,5,2.5,0,7
IVB,British Virgin Islands,4,2014,0,0,0,0,1,0,1,0.0,0,1
ALB,Albania,4,2014,0,0,0,0,2,2,0,0.0,0,2
ARU,Aruba,3,2012,0,0,0,0,4,1,3,3.0,0,4
MKD,Macedonia,3,2012,0,0,0,0,4,2,2,1.0,0,4
CRO,Croatia,5,2016,24,7,15,2,93,24,69,2.875,24,69
UKR,Ukraine,4,2014,5,4,0,1,101,56,45,0.8035714285714286,5,96
GER,Germany-1,2,2010,8,2,4,2,12,3,9,3.0,8,4
NEP,Nepal,5,2016,0,0,0,0,7,4,3,0.75,0,7
CZE,Czech Republic-1,2,2010,0,0,0,0,4,0,4,0.0,0,4
MEX,Mexico,2,2010,0,0,0,0,2,0,2,0.0,0,2
RSA,South Africa,3,2012,9,6,2,1,145,61,84,1.3770491803278688,9,136
BAR,Barbados,3,2012,0,0,0,0,8,0,8,0.0,0,8
SUI,Switzerland-2,3,2012,0,0,0,0,2,0,2,0.0,0,2
BUL,Bulgaria,2,2010,0,0,0,0,41,15,26,1.7333333333333334,0,41
ITA,Italy-2,3,2012,0,0,0,0,4,3,1,0.3333333333333333,0,4
SVK,Slovakia,5,2016,8,3,5,0,63,24,39,1.625,8,55
FRA,France-1,5,2016,0,0,0,0,4,1,3,3.0,0,4
SEY,Seychelles,3,2012,0,0,0,0,6,2,4,2.0,0,6
DMA,Dominica,3,2012,0,0,0,0,2,1,1,1.0,0,2
NOR,Norway,2,2010,39,16,14,9,190,55,135,2.4545454545454546,39,151
POR,Portugal,5,2016,1,0,0,1,106,34,72,2.1176470588235294,1,105
SUI,Switzerland-2,5,2016,0,0,0,0,2,2,0,0.0,0,2
BRU,Brunei,5,2016,0,0,0,0,3,1,2,2.0,0,3
KOR,South Korea,2,2010,18,6,10,2,84,35,49,1.4,18,66
INA,Indonesia-1,5,2016,2,2,0,0,2,1,1,1.0,2,0
SUI,Switzerland-1,4,2014,2,0,2,0,2,0,2,0.0,2,0
DJI,Djibouti,3,2012,0,0,0,0,4,2,2,1.0,0,4
TLS,Timor Leste,3,2012,0,0,0,0,2,1,1,1.0,0,2
ITA,Italy,2,2010,5,1,1,3,196,78,118,1.5128205128205128,5,191
USA,United States,5,2016,256,137,52,67,699,359,340,0.947075208913649,256,443
AUS,Australia-1,5,2016,0,0,0,0,4,4,0,0.0,0,4
FRA,France-2,5,2016,0,0,0,0,4,1,3,3.0,0,4
SUI,Switzerland,3,2012,4,2,2,0,122,37,85,2.2972972972972974,4,118
GUI,Guinea,3,2012,0,0,0,0,4,2,2,1.0,0,4
FRA,France-1,3,2012,2,0,2,0,2,0,2,0.0,2,0
TOG,Togo,4,2014,0,0,0,0,3,3,0,0.0,0,3
IND,India-2,3,2012,0,0,0,0,2,0,2,0.0,0,2
ANG,Angola,5,2016,0,0,0,0,26,18,8,0.4444444444444444,0,26
GUY,Guyana,5,2016,0,0,0,0,7,4,3,0.75,0,7
COD,Congo (Kinshasa),5,2016,0,0,0,0,4,2,2,1.0,0,4
EGY,Egypt,5,2016,3,0,0,3,137,46,91,1.9782608695652173,3,134
ISV,United States Virgin Islands,4,2014,0,0,0,0,2,2,0,0.0,0,2
ITA,Italy,4,2014,14,0,2,12,215,92,123,1.3369565217391304,14,201
INA,Indonesia,3,2012,2,0,1,1,22,9,13,1.4444444444444444,2,20
ISR,Israel,3,2012,0,0,0,0,56,23,33,1.434782608695652,0,56
IOA,Individual Olympic Athletes,3,2012,0,0,0,0,4,1,3,3.0,0,4
JAM,Jamaica,5,2016,30,11,17,2,77,43,34,0.7906976744186046,30,47
ARG,Argentina-1,5,2016,0,0,0,0,2,0,2,0.0,0,2
FIN,Finland,4,2014,33,2,7,24,147,52,95,1.8269230769230769,33,114
CHA,Chad,3,2012,0,0,0,0,2,2,0,0.0,0,2
NIG,Niger,3,2012,0,0,0,0,6,2,4,2.0,0,6
KEN,Kenya,5,2016,13,6,6,1,80,34,46,1.3529411764705883,13,67
CAM,Cambodia,5,2016,0,0,0,0,6,4,2,0.5,0,6
MAR,Morocco,4,2014,0,0,0,0,4,2,2,1.0,0,4
GBR,Great Britain,4,2014,10,1,4,5,70,31,39,1.2580645161290323,10,60
GBR,Great Britain-1,4,2014,0,0,0,0,4,0,4,0.0,0,4
PAN,Panama,3,2012,0,0,0,0,8,2,6,3.0,0,8
KOR,South Korea,5,2016,24,13,3,8,255,114,141,1.236842105263158,24,231
AUS,Australia-2,5,2016,0,0,0,0,4,4,0,0.0,0,4
PAR,Paraguay,4,2014,0,0,0,0,1,1,0,0.0,0,1
BIZ,Belize,3,2012,0,0,0,0,3,1,2,2.0,0,3
AFG,Afghanistan,5,2016,0,0,0,0,3,1,2,2.0,0,3
AND,Andorra,3,2012,0,0,0,0,6,2,4,2.0,0,6
AUS,Australia,2,2010,3,2,1,0,44,23,21,0.9130434782608695,3,41
MTN,Mauritania,3,2012,0,0,0,0,2,1,1,1.0,0,2
GBS,Guinea Bissau,3,2012,0,0,0,0,4,2,2,1.0,0,4
VIN,Saint Vincent and the Grenadines,3,2012,0,0,0,0,3,1,2,2.0,0,3
IRL,Ireland,5,2016,3,0,3,0,93,31,62,2.0,3,90
TJK,Tajikistan,4,2014,0,0,0,0,1,0,1,0.0,0,1
ARM,Armenia,3,2012,3,0,1,2,31,4,27,6.75,3,28
HKG,Hong Kong,2,2010,0,0,0,0,3,3,0,0.0,0,3
ANT,Antigua and Barbuda,5,2016,0,0,0,0,9,2,7,3.5,0,9
CGO,Congo (Brazzaville),5,2016,0,0,0,0,10,3,7,2.3333333333333335,0,10
NOR,Norway,3,2012,17,15,1,1,69,32,37,1.15625,17,52
BDI,Burundi,5,2016,1,0,1,0,10,4,6,1.5,1,9
ESP,Spain-2,3,2012,0,0,0,0,4,2,2,1.0,0,4
PHI,Philippines,5,2016,1,0,1,0,13,6,7,1.1666666666666667,1,12
SUR,Suriname,5,2016,0,0,0,0,6,2,4,2.0,0,6
AUS,Australia,4,2014,3,0,2,1,84,43,41,0.9534883720930233,3,81
COM,Comoros,3,2012,0,0,0,0,3,2,1,0.5,0,3
IND,India-1,3,2012,0,0,0,0,2,0,2,0.0,0,2
BLR,Belarus,5,2016,12,1,4,7,142,77,65,0.8441558441558441,12,130
USA,United States-1,5,2016,4,0,2,2,10,5,5,1.0,4,6
SYR,Syria,5,2016,0,0,0,0,7,3,4,1.3333333333333333,0,7
POL,Poland,3,2012,12,2,2,8,252,107,145,1.355140186915888,12,240
BRA,Brazil-1,3,2012,4,0,2,2,6,2,4,2.0,4,2
FRA,France,4,2014,18,4,4,10,189,72,117,1.625,18,171
MNE,Montenegro,4,2014,0,0,0,0,3,1,2,2.0,0,3
CHN,China-2,4,2014,0,0,0,0,2,1,1,1.0,0,2
TJK,Tajikistan,3,2012,1,0,0,1,16,3,13,4.333333333333333,1,15
BRA,Brazil-2,3,2012,0,0,0,0,6,2,4,2.0,0,6
ARM,Armenia,2,2010,0,0,0,0,6,3,3,1.0,0,6
SLE,Sierra Leone,5,2016,0,0,0,0,4,2,2,1.0,0,4
BOL,Bolivia,5,2016,0,0,0,0,12,6,6,1.0,0,12
LCA,Saint Lucia,5,2016,0,0,0,0,5,3,2,0.6666666666666666,0,5
HUN,Hungary,3,2012,26,12,8,6,201,88,113,1.2840909090909092,26,175
EST,Estonia,5,2016,4,0,0,4,49,21,28,1.3333333333333333,4,45
CAN,Canada-1,5,2016,0,0,0,0,4,2,2,1.0,0,4
NEP,Nepal,4,2014,0,0,0,0,1,0,1,0.0,0,1
AUS,Australia-1,3,2012,0,0,0,0,4,4,0,0.0,0,4
FIN,Finland,5,2016,1,0,0,1,67,33,34,1.0303030303030303,1,66
ROT,Refugee Olympic Athletes,5,2016,0,0,0,0,12,5,7,1.4,0,12
MLI,Mali,5,2016,0,0,0,0,6,2,4,2.0,0,6
FIN,Finland,3,2012,5,0,1,4,69,37,32,0.8648648648648649,5,64
LIB,Lebanon,2,2010,0,0,0,0,6,4,2,0.5,0,6
SYR,Syria,3,2012,0,0,0,0,10,4,6,1.5,0,10
MAR,Morocco,5,2016,1,0,0,1,52,21,31,1.4761904761904763,1,51
ECU,Ecuador,5,2016,0,0,0,0,40,16,24,1.5,0,40
TTO,Trinidad and Tobago,5,2016,1,0,0,1,43,18,25,1.3888888888888888,1,42
KGZ,Kyrgyzstan,4,2014,0,0,0,0,2,0,2,0.0,0,2
BEN,Benin,3,2012,0,0,0,0,5,1,4,4.0,0,5
CAN,Canada,2,2010,80,63,13,4,279,130,149,1.146153846153846,80,199
FIN,Finland,2,2010,47,0,1,46,146,53,93,1.7547169811320755,47,99
GHA,Ghana,5,2016,0,0,0,0,15,8,7,0.875,0,15
CHI,Chile,5,2016,0,0,0,0,47,21,26,1.2380952380952381,0,47
VIN,Saint Vincent and the Grenadines,5,2016,0,0,0,0,4,2,2,1.0,0,4
FRA,France-1,4,2014,0,0,0,0,6,1,5,5.0,0,6
MAR,Morocco,3,2012,1,0,0,1,67,19,48,2.526315789473684,1,66
POL,Poland-1,3,2012,0,0,0,0,2,2,0,0.0,0,2
ITA,Italy-1,3,2012,0,0,0,0,4,3,1,0.3333333333333333,0,4
POR,Portugal,2,2010,0,0,0,0,1,0,1,0.0,0,1
QAT,Qatar,5,2016,1,0,1,0,42,2,40,20.0,1,41
MGL,Mongolia,5,2016,2,0,1,1,46,20,26,1.3,2,44
MYA,Myanmar,5,2016,0,0,0,0,8,3,5,1.6666666666666667,0,8
GER,Germany-1,3,2012,2,2,0,0,8,5,3,0.6,2,6
SRB,Serbia,2,2010,0,0,0,0,15,8,7,0.875,0,15
DEN,Denmark,2,2010,0,0,0,0,23,10,13,1.3,0,23
MNE,Montenegro,5,2016,0,0,0,0,35,18,17,0.9444444444444444,0,35
ROU,Romania,4,2014,0,0,0,0,40,15,25,1.6666666666666667,0,40
CPV,Cape Verde,3,2012,0,0,0,0,3,2,1,0.5,0,3
MAD,Madagascar,3,2012,0,0,0,0,7,4,3,0.75,0,7
SRB,Serbia-1,3,2012,0,0,0,0,2,0,2,0.0,0,2
AUT,Austria,2,2010,24,9,9,6,124,41,83,2.024390243902439,24,100
MON,Monaco,5,2016,0,0,0,0,8,0,8,0.0,0,8
ISR,Israel,4,2014,0,0,0,0,6,1,5,5.0,0,6
CZE,Czech Republic,2,2010,9,2,0,7,164,52,112,2.1538461538461537,9,155
STP,Sao Tome and Principe,3,2012,0,0,0,0,2,1,1,1.0,0,2
ITA,Italy-2,2,2010,0,0,0,0,6,1,5,5.0,0,6
GBS,Guinea Bissau,5,2016,0,0,0,0,5,2,3,1.5,0,5
IRI,Iran,2,2010,0,0,0,0,7,2,5,2.5,0,7
GBR,Great Britain-2,3,2012,2,0,2,0,6,2,4,2.0,2,4
KOR,South Korea-1,3,2012,2,0,0,2,4,2,2,1.0,2,2
KIR,Kiribati,5,2016,0,0,0,0,3,1,2,2.0,0,3
MKD,Macedonia,4,2014,0,0,0,0,6,1,5,5.0,0,6
LUX,Luxembourg,3,2012,0,0,0,0,11,4,7,1.75,0,11
NED,Netherlands-2,3,2012,0,0,0,0,2,2,0,0.0,0,2
GRN,Grenada,5,2016,1,0,1,0,6,1,5,5.0,1,5
UKR,Ukraine-1,2,2010,0,0,0,0,4,1,3,3.0,0,4
LAO,Laos,5,2016,0,0,0,0,5,2,3,1.5,0,5
KEN,Kenya,3,2012,11,2,4,5,51,22,29,1.3181818181818181,11,40
USA,United States-2,3,2012,2,0,2,0,10,5,5,1.0,2,8
BHU,Bhutan,3,2012,0,0,0,0,2,2,0,0.0,0,2
FRA,France,5,2016,96,20,55,21,504,215,289,1.344186046511628,96,408
COM,Comoros,5,2016,0,0,0,0,4,2,2,1.0,0,4
BIH,Bosnia and Herzegovina,4,2014,0,0,0,0,14,5,9,1.8,0,14
BRN,Bahrain,3,2012,1,0,0,1,14,10,4,0.4,1,13
HKG,Hong Kong,5,2016,0,0,0,0,47,30,17,0.5666666666666667,0,47
TPE,Chinese Taipei,5,2016,5,1,0,4,67,36,31,0.8611111111111112,5,62
ANG,Angola,3,2012,0,0,0,0,35,29,6,0.20689655172413793,0,35
LAT,Latvia-1,3,2012,2,0,0,2,2,0,2,0.0,2,0
TGA,Tonga,5,2016,0,0,0,0,7,3,4,1.3333333333333333,0,7
CAN,Canada-3,4,2014,0,0,0,0,12,2,10,5.0,0,12
CHN,China-1,4,2014,0,0,0,0,2,1,1,1.0,0,2
LAO,Laos,3,2012,0,0,0,0,3,1,2,2.0,0,3
NGR,Nigeria,5,2016,18,0,0,18,77,28,49,1.75,18,59
NRU,Nauru,5,2016,0,0,0,0,2,0,2,0.0,0,2
PAK,Pakistan,5,2016,0,0,0,0,7,3,4,1.3333333333333333,0,7
ISL,Iceland,3,2012,0,0,0,0,36,12,24,2.0,0,36
ITA,Italy,5,2016,70,8,38,24,395,186,209,1.1236559139784945,70,325
LTU,Lithuania,5,2016,7,0,2,5,80,20,60,3.0,7,73
KOR,South Korea-2,5,2016,0,0,0,0,4,2,2,1.0,0,4
IRI,Iran,3,2012,12,4,5,3,57,11,46,4.181818181818182,12,45
ESP,Spain-1,3,2012,0,0,0,0,4,2,2,1.0,0,4
MNE,Montenegro,2,2010,0,0,0,0,2,0,2,0.0,0,2
AND,Andorra,2,2010,0,0,0,0,20,7,13,1.8571428571428572,0,20
RUS,Russia-3,2,2010,0,0,0,0,8,2,6,3.0,0,8
CAY,Cayman Islands,5,2016,0,0,0,0,5,2,3,1.5,0,5
COL,Colombia,5,2016,8,3,2,3,157,76,81,1.0657894736842106,8,149
GUA,Guatemala,5,2016,0,0,0,0,25,10,15,1.5,0,25
BER,Bermuda,4,2014,0,0,0,0,1,0,1,0.0,0,1
GBR,Great Britain,3,2012,122,46,28,48,672,330,342,1.0363636363636364,122,550
PNG,Papua New Guinea,3,2012,0,0,0,0,8,4,4,1.0,0,8
ALG,Algeria,5,2016,2,0,2,0,74,13,61,4.6923076923076925,2,72
BAH,Bahamas,5,2016,6,1,0,5,38,17,21,1.2352941176470589,6,32
PAK,Pakistan,4,2014,0,0,0,0,1,0,1,0.0,0,1
JAM,Jamaica,3,2012,25,8,9,8,62,33,29,0.8787878787878788,25,37
GER,Germany-2,2,2010,4,0,2,2,12,3,9,3.0,4,8
BRN,Bahrain,5,2016,2,1,1,0,33,13,20,1.5384615384615385,2,31
GBR,Great Britain-2,5,2016,0,0,0,0,4,1,3,3.0,0,4
BIZ,Belize,5,2016,0,0,0,0,3,1,2,2.0,0,3
SWE,Sweden,5,2016,28,2,23,3,186,112,74,0.6607142857142857,28,158
LAT,Latvia,4,2014,5,0,1,4,66,13,53,4.076923076923077,5,61
UZB,Uzbekistan,3,2012,3,1,0,2,56,19,37,1.9473684210526316,3,53
NED,Netherlands,2,2010,11,4,1,6,65,35,30,0.8571428571428571,11,54
POL,Poland,5,2016,16,3,3,10,285,125,160,1.28,16,269
CHN,China-2,5,2016,0,0,0,0,8,5,3,0.6,0,8
MHL,Marshall Islands,5,2016,0,0,0,0,5,3,2,0.6666666666666666,0,5
SUI,Switzerland-1,5,2016,0,0,0,0,2,2,0,0.0,0,2
MEX,Mexico,3,2012,24,16,5,3,119,45,74,1.6444444444444444,24,95
FSM,Federated States of Micronesia,3,2012,0,0,0,0,6,2,4,2.0,0,6
GER,Germany,2,2010,42,13,18,11,227,97,130,1.3402061855670102,42,185
CYP,Cyprus,4,2014,0,0,0,0,2,0,2,0.0,0,2
LIB,Lebanon,3,2012,0,0,0,0,10,7,3,0.42857142857142855,0,10
SUI,Switzerland,2,2010,12,6,0,6,186,62,124,2.0,12,174
GBR,Great Britain,5,2016,145,64,55,26,470,210,260,1.2380952380952381,145,325
PLW,Palau,5,2016,0,0,0,0,6,3,3,1.0,0,6
OMA,Oman,3,2012,0,0,0,0,3,1,2,2.0,0,3
CAN,Canada,5,2016,69,4,4,61,397,250,147,0.588,69,328
AUT,Austria-2,5,2016,0,0,0,0,2,0,2,0.0,0,2
CAN,Canada-2,5,2016,0,0,0,0,4,2,2,1.0,0,4
IRL,Ireland,4,2014,0,0,0,0,8,2,6,3.0,0,8
IRL,Ireland,2,2010,0,0,0,0,7,4,3,0.75,0,7
SRB,Serbia,5,2016,54,14,27,13,127,57,70,1.2280701754385965,54,73
UKR,Ukraine-1,5,2016,0,0,0,0,2,2,0,0.0,0,2
HKG,Hong Kong,4,2014,0,0,0,0,1,0,1,0.0,0,1
IOA,Individual Olympic Athletes,4,2014,0,0,0,0,1,0,1,0.0,0,1
BRA,Brazil,3,2012,55,14,32,9,294,140,154,1.1,55,239
LAT,Latvia,3,2012,1,1,0,0,46,14,32,2.2857142857142856,1,45
GBR,Great Britain-1,5,2016,0,0,0,0,4,1,3,3.0,0,4
MOZ,Mozambique,5,2016,0,0,0,0,8,1,7,7.0,0,8
ITA,Italy-2,4,2014,0,0,0,0,6,2,4,2.0,0,6
JAM,Jamaica,4,2014,0,0,0,0,2,0,2,0.0,0,2
HUN,Hungary,2,2010,0,0,0,0,32,21,11,0.5238095238095238,0,32
AUS,Australia-1,2,2010,0,0,0,0,3,0,3,0.0,0,3
CUB,Cuba,5,2016,11,5,2,4,143,43,100,2.3255813953488373,11,132
VEN,Venezuela,5,2016,3,0,1,2,105,29,76,2.6206896551724137,3,102
CAF,Central African Republic,5,2016,0,0,0,0,6,3,3,1.0,0,6
NOR,Norway,4,2014,36,18,5,13,219,77,142,1.844155844155844,36,183
LAT,Latvia-1,2,2010,2,0,2,0,2,0,2,0.0,2,0
CAF,Central African Republic,3,2012,0,0,0,0,6,3,3,1.0,0,6
BRA,Brazil,2,2010,0,0,0,0,7,4,3,0.75,0,7
CHN,China,3,2012,117,50,38,29,463,257,206,0.8015564202334631,117,346
CMR,Cameroon,3,2012,0,0,0,0,32,22,10,0.45454545454545453,0,32
MNE,Montenegro,3,2012,14,0,14,0,34,15,19,1.2666666666666666,14,20
BER,Bermuda,3,2012,0,0,0,0,8,3,5,1.6666666666666667,0,8
CYP,Cyprus,3,2012,1,0,1,0,13,4,9,2.25,1,12
SVK,Slovakia,3,2012,5,0,1,4,65,30,35,1.1666666666666667,5,60
CZE,Czech Republic-2,3,2012,0,0,0,0,6,4,2,0.5,0,6
FRA,France-2,3,2012,2,0,0,2,2,0,2,0.0,2,0
USA,United States-1,2,2010,6,4,2,0,14,4,10,2.5,6,8
ITA,Italy-1,2,2010,0,0,0,0,6,1,5,5.0,0,6
ARM,Armenia,5,2016,4,1,3,0,34,10,24,2.4,4,30
TLS,Timor Leste,5,2016,0,0,0,0,3,2,1,0.5,0,3
GEQ,Equatorial Guinea,5,2016,0,0,0,0,1,0,1,0.0,0,1
GRE,Greece,4,2014,0,0,0,0,13,3,10,3.3333333333333335,0,13
POL,Poland,2,2010,8,1,3,4,106,61,45,0.7377049180327869,8,98
BLR,Belarus,2,2010,3,1,1,1,95,42,53,1.2619047619047619,3,92
BIH,Bosnia and Herzegovina,2,2010,0,0,0,0,10,7,3,0.42857142857142855,0,10
IRI,Iran,5,2016,8,3,1,4,67,11,56,5.090909090909091,8,59
BUL,Bulgaria,3,2012,2,0,1,1,75,36,39,1.0833333333333333,2,73
ECU,Ecuador,3,2012,0,0,0,0,36,13,23,1.7692307692307692,0,36
AUT,Austria-2,2,2010,0,0,0,0,4,0,4,0.0,0,4
BUR,Burkina Faso,5,2016,0,0,0,0,5,2,3,1.5,0,5
BRA,Brazil-2,5,2016,0,0,0,0,6,2,4,2.0,0,6
MAS,Malaysia,3,2012,2,0,1,1,38,16,22,1.375,2,36
AUT,Austria,5,2016,2,0,0,2,81,40,41,1.025,2,79
TUR,Turkey,3,2012,5,2,2,1,119,67,52,0.7761194029850746,5,114
DEN,Denmark-2,3,2012,0,0,0,0,2,1,1,1.0,0,2
CHI,Chile,4,2014,0,0,0,0,14,6,8,1.3333333333333333,0,14
IND,India,4,2014,0,0,0,0,2,0,2,0.0,0,2
BRU,Brunei,3,2012,0,0,0,0,3,1,2,2.0,0,3
ROU,Romania-2,2,2010,0,0,0,0,2,0,2,0.0,0,2
ERI,Eritrea,3,2012,0,0,0,0,12,1,11,11.0,0,12
SKN,Saint Kitts and Nevis,3,2012,0,0,0,0,7,0,7,0.0,0,7
TUR,Turkey,2,2010,0,0,0,0,9,6,3,0.5,0,9
JOR,Jordan,3,2012,0,0,0,0,9,4,5,1.25,0,9
DEN,Denmark,5,2016,41,15,10,16,143,61,82,1.3442622950819672,41,102
ARG,Argentina,5,2016,22,21,1,0,228,82,146,1.7804878048780488,22,206
FIJ,Fiji,5,2016,13,13,0,0,53,17,36,2.1176470588235294,13,40
COL,Colombia,2,2010,0,0,0,0,2,2,0,0.0,0,2
ERI,Eritrea,5,2016,0,0,0,0,12,1,11,11.0,0,12
NAM,Namibia,5,2016,0,0,0,0,11,6,5,0.8333333333333334,0,11
ISV,United States Virgin Islands,5,2016,0,0,0,0,7,2,5,2.5,0,7
ASA,American Samoa,5,2016,0,0,0,0,4,1,3,3.0,0,4
MTN,Mauritania,5,2016,0,0,0,0,2,1,1,1.0,0,2
POL,Poland,4,2014,11,4,4,3,149,73,76,1.0410958904109588,11,138
EST,Estonia,4,2014,0,0,0,0,66,20,46,2.3,0,66
JPN,Japan,3,2012,82,7,42,33,395,196,199,1.0153061224489797,82,313
NEP,Nepal,3,2012,0,0,0,0,5,3,2,0.6666666666666666,0,5
GER,Germany-3,2,2010,0,0,0,0,8,2,6,3.0,0,8
MGL,Mongolia,4,2014,0,0,0,0,2,1,1,1.0,0,2
LIE,Liechtenstein,4,2014,0,0,0,0,5,1,4,4.0,0,5
GEO,Georgia,3,2012,7,1,3,3,36,8,28,3.5,7,29
MLI,Mali,3,2012,0,0,0,0,6,2,4,2.0,0,6
JPN,Japan,2,2010,7,0,5,2,153,72,81,1.125,7,146
MRI,Mauritius,5,2016,0,0,0,0,11,6,5,0.8333333333333334,0,11
FIJ,Fiji,3,2012,0,0,0,0,9,3,6,2.0,0,9
BHU,Bhutan,5,2016,0,0,0,0,2,2,0,0.0,0,2
SWE,Sweden,3,2012,22,2,17,3,168,102,66,0.6470588235294118,22,146
GRN,Grenada,3,2012,1,1,0,0,8,3,5,1.6666666666666667,1,7
AZE,Azerbaijan,3,2012,10,2,2,6,59,16,43,2.6875,10,49
SVK,Slovakia,2,2010,3,1,1,1,107,43,64,1.4883720930232558,3,104
SEN,Senegal,5,2016,0,0,0,0,22,16,6,0.375,0,22
BIH,Bosnia and Herzegovina,5,2016,0,0,0,0,11,4,7,1.75,0,11
GER,Germany,4,2014,32,13,12,7,235,116,119,1.0258620689655173,32,203
FRA,France,3,2012,78,30,28,20,422,183,239,1.3060109289617485,78,344
KOR,South Korea-2,3,2012,0,0,0,0,4,2,2,1.0,0,4
GBR,Great Britain-2,4,2014,0,0,0,0,4,0,4,0.0,0,4
SMR,San Marino,3,2012,0,0,0,0,4,3,1,0.3333333333333333,0,4
MYA,Myanmar,3,2012,0,0,0,0,6,3,3,1.0,0,6
USA,United States-1,3,2012,8,6,0,2,10,5,5,1.0,8,2
LAT,Latvia,5,2016,0,0,0,0,33,13,20,1.5384615384615385,0,33
VIE,Vietnam,5,2016,2,1,1,0,28,16,12,0.75,2,26
HUN,Hungary,4,2014,0,0,0,0,37,22,15,0.6818181818181818,0,37
HAI,Haiti,5,2016,0,0,0,0,10,3,7,2.3333333333333335,0,10
COL,Colombia,3,2012,8,1,3,4,120,64,56,0.875,8,112
CAM,Cambodia,3,2012,0,0,0,0,6,3,3,1.0,0,6
SWE,Sweden,2,2010,18,11,3,4,172,80,92,1.15,18,154
ESP,Spain,5,2016,43,7,19,17,353,167,186,1.1137724550898203,43,310
RUS,Russia-2,4,2014,2,0,2,0,14,4,10,2.5,2,12
KSA,Saudi Arabia,5,2016,0,0,0,0,11,3,8,2.6666666666666665,0,11
USA,United States-2,5,2016,4,2,0,2,10,5,5,1.0,4,6
BUL,Bulgaria,4,2014,0,0,0,0,47,10,37,3.7,0,47
VEN,Venezuela,4,2014,0,0,0,0,1,0,1,0.0,0,1
CRC,Costa Rica,3,2012,0,0,0,0,11,3,8,2.6666666666666665,0,11
JOR,Jordan,5,2016,1,1,0,0,8,1,7,7.0,1,7
ARM,Armenia,4,2014,0,0,0,0,6,1,5,5.0,0,6
DOM,Dominican Republic,3,2012,2,1,1,0,36,21,15,0.7142857142857143,2,34
AZE,Azerbaijan,2,2010,0,0,0,0,4,2,2,1.0,0,4
IOA,Individual Olympic Athletes,5,2016,2,1,0,1,9,1,8,8.0,2,7
JPN,Japan,5,2016,64,17,13,34,436,209,227,1.0861244019138756,64,372
LES,Lesotho,5,2016,0,0,0,0,9,1,8,8.0,0,9
RUS,Russia,3,2012,138,50,39,49,541,275,266,0.9672727272727273,138,403
GER,Germany-2,3,2012,0,0,0,0,8,5,3,0.6,0,8
CYP,Cyprus,5,2016,0,0,0,0,21,7,14,2.0,0,21
MKD,Macedonia,2,2010,0,0,0,0,4,1,3,3.0,0,4
IND,India,5,2016,2,0,1,1,130,62,68,1.096774193548387,2,128
CHI,Chile,3,2012,0,0,0,0,44,18,26,1.4444444444444444,0,44
BLR,Belarus,3,2012,23,3,12,8,185,86,99,1.1511627906976745,23,162
EST,Estonia,2,2010,1,0,1,0,64,27,37,1.3703703703703705,1,63
ESA,El Salvador,5,2016,0,0,0,0,10,3,7,2.3333333333333335,0,10
MOZ,Mozambique,3,2012,0,0,0,0,6,2,4,2.0,0,6
ETH,Ethiopia,5,2016,8,1,2,5,38,21,17,0.8095238095238095,8,30
PNG,Papua New Guinea,5,2016,0,0,0,0,8,2,6,3.0,0,8
CAN,Canada-2,2,2010,2,0,2,0,14,4,10,2.5,2,12
USA,United States-2,2,2010,2,0,0,2,14,4,10,2.5,2,12
MAS,Malaysia,5,2016,8,0,7,1,42,19,23,1.2105263157894737,8,34
CRC,Costa Rica,5,2016,0,0,0,0,12,5,7,1.4,0,12
NED,Netherlands,4,2014,29,13,7,9,82,41,41,1.0,29,53
FRA,France-2,4,2014,0,0,0,0,6,1,5,5.0,0,6
SLO,Slovenia,2,2010,3,0,2,1,107,46,61,1.326086956521739,3,104
CZE,Czech Republic-2,2,2010,0,0,0,0,4,0,4,0.0,0,4
MDA,Moldova,5,2016,0,0,0,0,23,9,14,1.5555555555555556,0,23
SUI,Switzerland-2,4,2014,0,0,0,0,2,0,2,0.0,0,2
FRA,France-2,2,2010,0,0,0,0,2,1,1,1.0,0,2
LBR,Liberia,5,2016,0,0,0,0,3,1,2,2.0,0,3
YEM,Yemen,5,2016,0,0,0,0,3,1,2,2.0,0,3
AFG,Afghanistan,3,2012,1,0,0,1,6,1,5,5.0,1,5
UKR,Ukraine,2,2010,0,0,0,0,87,49,38,0.7755102040816326,0,87
NZL,New Zealand,2,2010,0,0,0,0,22,9,13,1.4444444444444444,0,22
CYP,Cyprus,2,2010,0,0,0,0,4,2,2,1.0,0,4
POL,Poland-2,5,2016,0,0,0,0,2,0,2,0.0,0,2
TUR,Turkey,4,2014,0,0,0,0,11,6,5,0.8333333333333334,0,11
LUX,Luxembourg,4,2014,0,0,0,0,1,0,1,0.0,0,1
CAN,Canada,3,2012,55,1,21,33,354,208,146,0.7019230769230769,55,299
ANT,Antigua and Barbuda,3,2012,0,0,0,0,4,2,2,1.0,0,4
CIV,Cote d'Ivoire,3,2012,0,0,0,0,10,6,4,0.6666666666666666,0,10
NED,Netherlands,5,2016,45,9,25,11,321,172,149,0.8662790697674418,45,276
GEO,Georgia,5,2016,7,2,1,4,45,14,31,2.2142857142857144,7,38
TOG,Togo,5,2016,0,0,0,0,5,3,2,0.6666666666666666,0,5
UKR,Ukraine,5,2016,15,2,8,5,268,141,127,0.900709219858156,15,253
CAN,Canada,4,2014,82,57,20,5,323,148,175,1.1824324324324325,82,241
CGO,Congo (Brazzaville),3,2012,0,0,0,0,7,3,4,1.3333333333333333,0,7
CHN,China-1,5,2016,4,2,0,2,8,5,3,0.6,4,4
DMA,Dominica,5,2016,0,0,0,0,2,1,1,1.0,0,2
INA,Indonesia-2,5,2016,0,0,0,0,2,1,1,1.0,0,2
SVK,Slovakia,4,2014,1,1,0,0,111,41,70,1.7073170731707317,1,110
ROU,Romania,3,2012,16,2,8,6,155,73,82,1.1232876712328768,16,139
UZB,Uzbekistan,5,2016,13,4,2,7,80,27,53,1.962962962962963,13,67
CIV,Cote d'Ivoire,5,2016,2,1,0,1,15,9,6,0.6666666666666666,2,13
PLE,Palestine,3,2012,0,0,0,0,5,2,3,1.5,0,5
MEX,Mexico,4,2014,0,0,0,0,1,0,1,0.0,0,1
CAN,Canada-1,2,2010,8,4,0,4,15,4,11,2.75,8,7
AUS,Australia-2,2,2010,0,0,0,0,2,0,2,0.0,0,2
AUT,Austria,3,2012,0,0,0,0,90,38,52,1.368421052631579,0,90
MON,Monaco,2,2010,0,0,0,0,6,4,2,0.5,0,6
GRE,Greece,2,2010,0,0,0,0,12,5,7,1.4,0,12
LIB,Lebanon,5,2016,0,0,0,0,9,5,4,0.8,0,9
POR,Portugal,4,2014,0,0,0,0,4,2,2,1.0,0,4
SOL,Solomon Islands,3,2012,0,0,0,0,4,2,2,1.0,0,4
NEP,Nepal,2,2010,0,0,0,0,1,0,1,0.0,0,1
TJK,Tajikistan,5,2016,1,1,0,0,7,2,5,2.5,1,6
VAN,Vanuatu,5,2016,0,0,0,0,4,0,4,0.0,0,4
PAR,Paraguay,3,2012,0,0,0,0,10,4,6,1.5,0,10
RWA,Rwanda,3,2012,0,0,0,0,7,2,5,2.5,0,7
PUR,Puerto Rico,3,2012,2,0,1,1,28,9,19,2.111111111111111,2,26
ROU,Romania,2,2010,0,0,0,0,45,28,17,0.6071428571428571,0,45
SUD,Sudan,5,2016,0,0,0,0,6,2,4,2.0,0,6
ESP,Spain,4,2014,0,0,0,0,39,11,28,2.5454545454545454,0,39
TTO,Trinidad and Tobago,3,2012,10,1,4,5,38,12,26,2.1666666666666665,10,28
QAT,Qatar,3,2012,2,0,0,2,14,5,9,1.8,2,12
POL,Poland-2,3,2012,0,0,0,0,2,2,0,0.0,0,2
KOR,South Korea,4,2014,14,7,5,2,118,54,64,1.1851851851851851,14,104
MDA,Moldova,3,2012,2,0,0,2,20,8,12,1.5,2,18
USA,United States-3,4,2014,0,0,0,0,6,3,3,1.0,0,6
KOR,South Korea-1,4,2014,0,0,0,0,6,0,6,0.0,0,6
RWA,Rwanda,5,2016,0,0,0,0,7,3,4,1.3333333333333333,0,7
MDV,Maldives,5,2016,0,0,0,0,4,2,2,1.0,0,4
ISR,Israel,5,2016,2,0,0,2,59,31,28,0.9032258064516129,2,57
PAN,Panama,5,2016,0,0,0,0,14,9,5,0.5555555555555556,0,14
CHA,Chad,5,2016,0,0,0,0,2,1,1,1.0,0,2
AZE,Azerbaijan,4,2014,0,0,0,0,4,1,3,3.0,0,4
BUR,Burkina Faso,3,2012,0,0,0,0,5,3,2,0.6666666666666666,0,5
THA,Thailand,3,2012,3,0,2,1,43,21,22,1.0476190476190477,3,40
CMR,Cameroon,5,2016,0,0,0,0,22,17,5,0.29411764705882354,0,22
SGP,Singapore,5,2016,1,1,0,0,32,20,12,0.6,1,31
BLR,Belarus,4,2014,6,5,0,1,72,30,42,1.4,6,66
GER,Germany-1,5,2016,2,2,0,0,4,4,0,0.0,2,2
BAN,Bangladesh,5,2016,0,0,0,0,7,3,4,1.3333333333333333,0,7
TUV,Tuvalu,5,2016,0,0,0,0,1,0,1,0.0,0,1
SVK,Slovakia-2,4,2014,0,0,0,0,2,0,2,0.0,0,2
DJI,Djibouti,5,2016,0,0,0,0,8,1,7,7.0,0,8
HUN,Hungary,5,2016,22,12,3,7,204,90,114,1.2666666666666666,22,182
RUS,Russia,2,2010,21,6,5,10,243,116,127,1.0948275862068966,21,222
MAD,Madagascar,5,2016,0,0,0,0,6,4,2,0.5,0,6
MAW,Malawi,5,2016,0,0,0,0,5,2,3,1.5,0,5
GER,Germany-3,4,2014,0,0,0,0,8,2,6,3.0,0,8
EGY,Egypt,3,2012,2,0,2,0,132,45,87,1.9333333333333333,2,130
GAM,Gambia,3,2012,0,0,0,0,2,1,1,1.0,0,2
PLE,Palestine,5,2016,0,0,0,0,6,2,4,2.0,0,6
MKD,Macedonia,5,2016,0,0,0,0,6,4,2,0.5,0,6
LTU,Lithuania,4,2014,0,0,0,0,20,11,9,0.8181818181818182,0,20
SMR,San Marino,4,2014,0,0,0,0,2,1,1,1.0,0,2
KSA,Saudi Arabia,3,2012,4,0,0,4,23,2,21,10.5,4,19
ITA,Italy,3,2012,68,16,22,30,374,164,210,1.2804878048780488,68,306
MRI,Mauritius,3,2012,0,0,0,0,11,7,4,0.5714285714285714,0,11
ITA,Italy-2,5,2016,0,0,0,0,2,0,2,0.0,0,2
GER,Germany-2,5,2016,0,0,0,0,4,4,0,0.0,0,4
CHN,China-1,3,2012,6,6,0,0,8,5,3,0.6,6,2
CHN,China-2,3,2012,2,0,2,0,8,5,3,0.6,2,6
CHN,China,5,2016,109,44,30,35,483,285,198,0.6947368421052632,109,374
GUI,Guinea,5,2016,0,0,0,0,5,3,2,0.6666666666666666,0,5
DOM,Dominican Republic,5,2016,1,0,0,1,30,8,22,2.75,1,29
EST,Estonia,3,2012,2,0,1,1,36,11,25,2.272727272727273,2,34
GUM,Guam,5,2016,0,0,0,0,5,2,3,1.5,0,5
TPE,Chinese Taipei,3,2012,2,0,1,1,55,33,22,0.6666666666666666,2,53
USA,United States-3,2,2010,0,0,0,0,10,3,7,2.3333333333333335,0,10
BEL,Belgium,4,2014,0,0,0,0,11,5,6,1.2,0,11
ALG,Algeria,3,2012,1,1,0,0,39,17,22,1.2941176470588236,1,38
IRQ,Iraq,3,2012,0,0,0,0,8,3,5,1.6666666666666667,0,8
SAM,Samoa,3,2012,0,0,0,0,9,3,6,2.0,0,9
DEN,Denmark,3,2012,14,3,5,6,145,71,74,1.0422535211267605,14,131
SGP,Singapore,3,2012,4,0,0,4,36,24,12,0.5,4,32
SUI,Switzerland-2,2,2010,0,0,0,0,2,2,0,0.0,0,2
STP,Sao Tome and Principe,5,2016,0,0,0,0,3,1,2,2.0,0,3
RUS,Russia,4,2014,56,25,20,11,317,142,175,1.232394366197183,56,261
THA,Thailand,4,2014,0,0,0,0,3,1,2,2.0,0,3
AUS,Australia,3,2012,114,18,37,59,506,235,271,1.1531914893617021,114,392
CAY,Cayman Islands,2,2010,0,0,0,0,1,0,1,0.0,0,1
PER,Peru,5,2016,0,0,0,0,34,15,19,1.2666666666666666,0,34
UAE,United Arab Emirates,3,2012,0,0,0,0,26,2,24,12.0,0,26
GEQ,Equatorial Guinea,3,2012,0,0,0,0,2,1,1,1.0,0,2
JPN,Japan-2,3,2012,0,0,0,0,2,2,0,0.0,0,2
NOR,Norway,5,2016,19,0,0,19,77,37,40,1.0810810810810811,19,58
MDV,Maldives,3,2012,0,0,0,0,5,2,3,1.5,0,5
RUS,Russia-1,4,2014,10,8,0,2,14,4,10,2.5,10,4
PER,Peru,3,2012,0,0,0,0,16,7,9,1.2857142857142858,0,16
DEN,Denmark-1,3,2012,2,0,0,2,2,1,1,1.0,2,0
ZIM,Zimbabwe,3,2012,0,0,0,0,9,5,4,0.8,0,9
IVB,British Virgin Islands,3,2012,0,0,0,0,2,1,1,1.0,0,2
KAZ,Kazakhstan,2,2010,1,0,1,0,100,48,52,1.0833333333333333,1,99
MGL,Mongolia,2,2010,0,0,0,0,2,1,1,1.0,0,2
SOM,Somalia,5,2016,0,0,0,0,2,1,1,1.0,0,2
SRB,Serbia,4,2014,0,0,0,0,17,5,12,2.4,0,17
INA,Indonesia,5,2016,2,0,2,0,27,9,18,2.0,2,25
BAH,Bahamas,3,2012,4,4,0,0,29,13,16,1.2307692307692308,4,25
COD,Congo (Kinshasa),3,2012,0,0,0,0,4,1,3,3.0,0,4
BOT,Botswana,5,2016,0,0,0,0,14,3,11,3.6666666666666665,0,14
NGR,Nigeria,3,2012,0,0,0,0,58,28,30,1.0714285714285714,0,58
GRE,Greece,3,2012,3,0,0,3,115,45,70,1.5555555555555556,3,112
AND,Andorra,5,2016,0,0,0,0,4,2,2,1.0,0,4
TUV,Tuvalu,3,2012,0,0,0,0,3,1,2,2.0,0,3
MEX,Mexico,5,2016,5,0,3,2,139,56,83,1.4821428571428572,5,134
USA,United States-1,4,2014,10,2,2,6,14,4,10,2.5,10,4
GER,Germany,3,2012,92,43,27,22,494,221,273,1.2352941176470589,92,402
KAZ,Kazakhstan,3,2012,13,7,1,5,132,47,85,1.8085106382978724,13,119
CRO,Croatia,3,2012,35,15,4,16,118,49,69,1.4081632653061225,35,83
MHL,Marshall Islands,3,2012,0,0,0,0,4,2,2,1.0,0,4
JPN,Japan-1,3,2012,2,0,2,0,2,2,0,0.0,2,0
ROU,Romania-1,2,2010,0,0,0,0,2,0,2,0.0,0,2
GAB,Gabon,5,2016,0,0,0,0,6,2,4,2.0,0,6
GER,Germany-1,4,2014,4,2,0,2,14,4,10,2.5,4,10
CRO,Croatia,4,2014,1,0,1,0,25,9,16,1.7777777777777777,1,24
GER,Germany-2,4,2014,0,0,0,0,14,4,10,2.5,0,14
MON,Monaco,3,2012,0,0,0,0,6,1,5,5.0,0,6
ARG,Argentina,2,2010,0,0,0,0,20,12,8,0.6666666666666666,0,20
NED,Netherlands-1,5,2016,2,0,0,2,4,2,2,1.0,2,2
BRA,Brazil-1,5,2016,4,2,2,0,6,2,4,2.0,4,2
TLS,Timor Leste,4,2014,0,0,0,0,1,0,1,0.0,0,1
HON,Honduras,3,2012,0,0,0,0,25,3,22,7.333333333333333,0,25
UGA,Uganda,5,2016,0,0,0,0,23,8,15,1.875,0,23
ESP,Spain-1,5,2016,0,0,0,0,6,3,3,1.0,0,6
LAT,Latvia-1,4,2014,6,0,4,2,8,0,8,0.0,6,2
GUM,Guam,3,2012,0,0,0,0,8,3,5,1.6666666666666667,0,8
NED,Netherlands-1,3,2012,0,0,0,0,2,2,0,0.0,0,2
TUR,Turkey,5,2016,8,1,3,4,119,54,65,1.2037037037037037,8,111
MDA,Moldova,4,2014,0,0,0,0,5,2,3,1.5,0,5
ROU,Romania,5,2016,16,4,2,10,117,71,46,0.647887323943662,16,101
RSA,South Africa,5,2016,23,2,7,14,155,46,109,2.369565217391304,23,132
IRQ,Iraq,5,2016,0,0,0,0,20,0,20,0.0,0,20
LAT,Latvia-2,4,2014,0,0,0,0,8,0,8,0.0,0,8
MGL,Mongolia,3,2012,5,0,2,3,32,14,18,1.2857142857142858,5,27
TAN,Tanzania,3,2012,0,0,0,0,6,2,4,2.0,0,6
YEM,Yemen,3,2012,0,0,0,0,4,1,3,3.0,0,4
SSD,South Sudan,5,2016,0,0,0,0,3,1,2,2.0,0,3
GEO,Georgia,4,2014,0,0,0,0,7,3,4,1.3333333333333333,0,7
PLW,Palau,3,2012,0,0,0,0,5,3,2,0.6666666666666666,0,5
LTU,Lithuania,2,2010,0,0,0,0,13,5,8,1.6,0,13
ARU,Aruba,5,2016,0,0,0,0,7,4,3,0.75,0,7
AUT,Austria,4,2014,25,4,10,11,209,74,135,1.8243243243243243,25,184
RUS,Russia-2,5,2016,2,2,0,0,4,2,2,1.0,2,2
KOS,Kosovo,5,2016,1,1,0,0,8,5,3,0.6,1,7
BEL,Belgium,3,2012,3,0,1,2,142,49,93,1.8979591836734695,3,139
NAM,Namibia,3,2012,0,0,0,0,9,4,5,1.25,0,9
SWZ,Swaziland,3,2012,0,0,0,0,3,1,2,2.0,0,3
SRB,Serbia-2,3,2012,0,0,0,0,2,0,2,0.0,0,2
SUI,Switzerland-1,3,2012,0,0,0,0,2,0,2,0.0,0,2
LIB,Lebanon,4,2014,0,0,0,0,3,1,2,2.0,0,3
PHI,Philippines,4,2014,0,0,0,0,1,0,1,0.0,0,1
ZAM,Zambia,3,2012,0,0,0,0,7,2,5,2.5,0,7
GBR,Great Britain,2,2010,1,1,0,0,68,24,44,1.8333333333333333,1,67
RUS,Russia-2,2,2010,0,0,0,0,14,4,10,2.5,0,14
KOR,South Korea,3,2012,59,18,13,28,304,132,172,1.303030303030303,59,245
MDA,Moldova,2,2010,0,0,0,0,11,4,7,1.75,0,11
GEO,Georgia,2,2010,0,0,0,0,9,4,5,1.25,0,9
TJK,Tajikistan,2,2010,0,0,0,0,4,0,4,0.0,0,4
TGA,Tonga,4,2014,0,0,0,0,1,0,1,0.0,0,1
NZL,New Zealand,3,2012,27,9,3,15,204,94,110,1.1702127659574468,27,177
RUS,Russia-1,2,2010,4,0,0,4,14,4,10,2.5,4,10
TGA,Tonga,3,2012,0,0,0,0,3,1,2,2.0,0,3
MLT,Malta,5,2016,0,0,0,0,8,4,4,1.0,0,8
MON,Monaco,4,2014,0,0,0,0,11,2,9,4.5,0,11
SUD,Sudan,3,2012,0,0,0,0,6,2,4,2.0,0,6
AUT,Austria-1,2,2010,2,2,0,0,4,0,4,0.0,2,2
TPE,Chinese Taipei,4,2014,0,0,0,0,5,0,5,0.0,0,5
MLT,Malta,4,2014,0,0,0,0,2,2,0,0.0,0,2
SRB,Serbia,3,2012,16,1,1,14,130,42,88,2.0952380952380953,16,114
IND,India,3,2012,6,0,2,4,91,29,62,2.1379310344827585,6,85
KGZ,Kyrgyzstan,2,2010,0,0,0,0,3,1,2,2.0,0,3
SUI,Switzerland,4,2014,28,6,2,20,215,94,121,1.2872340425531914,28,187
KOR,South Korea-1,5,2016,2,0,0,2,4,2,2,1.0,2,2
CAY,Cayman Islands,4,2014,0,0,0,0,2,0,2,0.0,0,2
GUY,Guyana,3,2012,0,0,0,0,6,2,4,2.0,0,6
IND,India,2,2010,0,0,0,0,3,0,3,0.0,0,3
LBA,Libya,5,2016,0,0,0,0,7,1,6,6.0,0,7
LIE,Liechtenstein,5,2016,0,0,0,0,3,2,1,0.5,0,3
UZB,Uzbekistan,4,2014,0,0,0,0,5,2,3,1.5,0,5
BRA,Brazil,5,2016,46,34,6,6,571,255,316,1.2392156862745098,46,525
CZE,Czech Republic-2,5,2016,0,0,0,0,2,2,0,0.0,0,2
UGA,Uganda,3,2012,1,1,0,0,16,4,12,3.0,1,15
ALB,Albania,2,2010,0,0,0,0,2,0,2,0.0,0,2
NZL,New Zealand,5,2016,36,6,25,5,232,114,118,1.0350877192982457,36,196
CZE,Czech Republic,4,2014,11,2,7,2,179,64,115,1.796875,11,168
TOG,Togo,3,2012,0,0,0,0,6,2,4,2.0,0,6
LAT,Latvia-2,3,2012,0,0,0,0,2,0,2,0.0,0,2
SLO,Slovenia,3,2012,5,1,1,3,78,48,30,0.625,5,73
KAZ,Kazakhstan,5,2016,18,3,5,10,123,57,66,1.1578947368421053,18,105
SMR,San Marino,5,2016,0,0,0,0,4,2,2,1.0,0,4
KUW,Kuwait,3,2012,1,0,0,1,12,3,9,3.0,1,11
GBR,Great Britain-1,3,2012,2,2,0,0,6,2,4,2.0,2,4
RUS,Russia-2,3,2012,0,0,0,0,4,4,0,0.0,0,4
LBR,Liberia,3,2012,0,0,0,0,3,2,1,0.5,0,3
SUI,Switzerland-1,2,2010,0,0,0,0,2,2,0,0.0,0,2
CZE,Czech Republic-1,5,2016,2,0,0,2,2,2,0,0.0,2,0
BOL,Bolivia,3,2012,0,0,0,0,5,2,3,1.5,0,5
ISR,Israel,2,2010,0,0,0,0,4,1,3,3.0,0,4
BAR,Barbados,5,2016,0,0,0,0,13,5,8,1.6,0,13
ROU,Romania-1,5,2016,0,0,0,0,2,2,0,0.0,0,2
GER,Germany,5,2016,157,47,43,67,528,238,290,1.218487394957983,157,371
NED,Netherlands-2,5,2016,0,0,0,0,4,2,2,1.0,0,4
ITA,Italy-1,4,2014,0,0,0,0,6,2,4,2.0,0,6
ISL,Iceland,2,2010,0,0,0,0,7,2,5,2.5,0,7
SWZ,Swaziland,5,2016,0,0,0,0,2,1,1,1.0,0,2
SVK,Slovakia-1,4,2014,0,0,0,0,2,0,2,0.0,0,2
GAB,Gabon,3,2012,1,0,1,0,21,2,19,9.5,1,20
SOM,Somalia,3,2012,0,0,0,0,2,1,1,1.0,0,2
KGZ,Kyrgyzstan,5,2016,0,0,0,0,19,7,12,1.7142857142857142,0,19
ALB,Albania,5,2016,0,0,0,0,6,3,3,1.0,0,6
VIE,Vietnam,3,2012,0,0,0,0,24,16,8,0.5,0,24
ALB,Albania,3,2012,0,0,0,0,10,3,7,2.3333333333333335,0,10
PAR,Paraguay,5,2016,0,0,0,0,11,5,6,1.2,0,11
ARG,Argentina-2,5,2016,0,0,0,0,2,0,2,0.0,0,2
MAW,Malawi,3,2012,0,0,0,0,3,2,1,0.5,0,3
MLT,Malta,3,2012,0,0,0,0,5,2,3,1.5,0,5
UZB,Uzbekistan,2,2010,0,0,0,0,5,3,2,0.6666666666666666,0,5
JPN,Japan,4,2014,11,1,4,6,171,96,75,0.78125,11,160
ISL,Iceland,4,2014,0,0,0,0,11,5,6,1.2,0,11
GHA,Ghana,3,2012,0,0,0,0,7,2,5,2.5,0,7
GRE,Greece,5,2016,7,3,1,3,104,37,67,1.8108108108108107,7,97
TAN,Tanzania,5,2016,0,0,0,0,7,2,5,2.5,0,7
LBA,Libya,3,2012,0,0,0,0,4,1,3,3.0,0,4
UKR,Ukraine,3,2012,26,9,5,12,304,143,161,1.1258741258741258,26,278
AUS,Australia-2,3,2012,0,0,0,0,4,4,0,0.0,0,4
KIR,Kiribati,3,2012,0,0,0,0,3,1,2,2.0,0,3
CRO,Croatia,2,2010,3,0,2,1,37,10,27,2.7,3,34
SWE,Sweden,4,2014,51,8,32,11,148,64,84,1.3125,51,97
DMA,Dominica,4,2014,0,0,0,0,1,0,1,0.0,0,1
ESP,Spain,2,2010,0,0,0,0,35,15,20,1.3333333333333333,0,35
LCA,Saint Lucia,3,2012,0,0,0,0,4,3,1,0.3333333333333333,0,4
TKM,Turkmenistan,3,2012,0,0,0,0,10,3,7,2.3333333333333335,0,10
FRA,France-1,2,2010,0,0,0,0,2,1,1,1.0,0,2
USA,United States,3,2012,238,139,55,44,669,333,336,1.009009009009009,238,431
HKG,Hong Kong,3,2012,1,0,0,1,55,29,26,0.896551724137931,1,54
SAM,Samoa,5,2016,0,0,0,0,9,4,5,1.25,0,9
ESP,Spain,3,2012,63,5,33,25,331,132,199,1.5075757575757576,63,268
CZE,Czech Republic-1,3,2012,2,0,2,0,6,4,2,0.5,2,4
AZE,Azerbaijan,5,2016,18,1,7,10,69,16,53,3.3125,18,51
GAM,Gambia,5,2016,0,0,0,0,4,1,3,3.0,0,4
RUS,Russia-1,5,2016,0,0,0,0,4,2,2,1.0,0,4
ARG,Argentina,4,2014,0,0,0,0,20,9,11,1.2222222222222223,0,20
LAT,Latvia,2,2010,1,0,1,0,77,20,57,2.85,1,76
PRK,North Korea,5,2016,7,2,3,2,38,25,13,0.52,7,31
CAN,Canada-1,4,2014,4,2,2,0,12,4,8,2.0,4,8
ETH,Ethiopia,3,2012,7,3,1,3,34,16,18,1.125,7,27
VEN,Venezuela,3,2012,1,1,0,0,85,36,49,1.3611111111111112,1,84
VAN,Vanuatu,3,2012,0,0,0,0,5,2,3,1.5,0,5
URU,Uruguay,5,2016,0,0,0,0,17,5,12,2.4,0,17
CHN,China,2,2010,15,7,1,7,121,80,41,0.5125,15,106
NIG,Niger,5,2016,1,0,1,0,6,2,4,2.0,1,5
COK,Cook Islands,5,2016,0,0,0,0,9,5,4,0.8,0,9
SRI,Sri Lanka,5,2016,0,0,0,0,10,2,8,4.0,0,10
BEN,Benin,5,2016,0,0,0,0,6,2,4,2.0,0,6
FSM,Federated States of Micronesia,5,2016,0,0,0,0,5,3,2,0.6666666666666666,0,5
CAN,Canada-2,4,2014,0,0,0,0,12,4,8,2.0,0,12
NCA,Nicaragua,5,2016,0,0,0,0,5,2,3,1.5,0,5
ROU,Romania-2,5,2016,0,0,0,0,2,2,0,0.0,0,2
CHN,China,4,2014,12,3,4,5,105,64,41,0.640625,12,93
USA,United States,4,2014,52,8,28,16,333,147,186,1.2653061224489797,52,281
IRL,Ireland,3,2012,5,1,1,3,76,34,42,1.2352941176470589,5,71
BDI,Burundi,3,2012,0,0,0,0,6,4,2,0.5,0,6
RUS,Russia-1,3,2012,2,0,0,2,4,4,0,0.0,2,2
BEL,Belgium,5,2016,21,2,17,2,138,53,85,1.6037735849056605,21,117
BER,Bermuda,5,2016,0,0,0,0,8,4,4,1.0,0,8
UKR,Ukraine-2,5,2016,0,0,0,0,2,2,0,0.0,0,2
DEN,Denmark,4,2014,0,0,0,0,15,4,11,2.75,0,15
URU,Uruguay,3,2012,0,0,0,0,27,3,24,8.0,0,27
GUA,Guatemala,3,2012,1,0,1,0,24,10,14,1.4,1,23
SUR,Suriname,3,2012,0,0,0,0,5,2,3,1.5,0,5
USA,United States,2,2010,89,8,61,20,303,134,169,1.2611940298507462,89,214
AUS,Australia,5,2016,82,23,34,25,510,255,255,1.0,82,428
KGZ,Kyrgyzstan,3,2012,0,0,0,0,15,3,12,4.0,0,15
ISL,Iceland,5,2016,0,0,0,0,14,10,4,0.4,0,14
ARG,Argentina,3,2012,19,1,15,3,148,45,103,2.2888888888888888,19,129
NRU,Nauru,3,2012,0,0,0,0,2,0,2,0.0,0,2
USA,United States-2,4,2014,2,0,0,2,14,4,10,2.5,2,12
LTU,Lithuania,3,2012,5,2,1,2,72,30,42,1.4,5,67
SLO,Slovenia,4,2014,8,2,2,4,116,41,75,1.829268292682927,8,108
TUN,Tunisia,5,2016,3,0,0,3,65,21,44,2.0952380952380953,3,62
SUI,Switzerland,5,2016,11,6,3,2,148,57,91,1.5964912280701755,11,137
KAZ,Kazakhstan,4,2014,1,0,0,1,115,41,74,1.8048780487804879,1,114
AND,Andorra,4,2014,0,0,0,0,12,5,7,1.4,0,12
IRI,Iran,4,2014,0,0,0,0,7,2,5,2.5,0,7
RUS,Russia-3,4,2014,0,0,0,0,8,2,6,3.0,0,8
PER,Peru,4,2014,0,0,0,0,5,2,3,1.5,0,5
NED,Netherlands,3,2012,69,21,29,19,218,101,117,1.1584158415841583,69,149
BEL,Belgium,2,2010,0,0,0,0,10,4,6,1.5,0,10
SEY,Seychelles,5,2016,0,0,0,0,10,2,8,4.0,0,10
TKM,Turkmenistan,5,2016,0,0,0,0,9,5,4,0.8,0,9
TUN,Tunisia,3,2012,3,1,1,1,87,21,66,3.142857142857143,3,84
POR,Portugal,3,2012,2,0,2,0,98,42,56,1.3333333333333333,2,96
PRK,North Korea,3,2012,6,4,0,2,57,40,17,0.425,6,51
SRI,Sri Lanka,3,2012,0,0,0,0,8,3,5,1.6666666666666667,0,8
COK,Cook Islands,3,2012,0,0,0,0,9,5,4,0.8,0,9
PHI,Philippines,3,2012,0,0,0,0,11,4,7,1.75,0,11
JAM,Jamaica,2,2010,0,0,0,0,1,0,1,0.0,0,1
SEN,Senegal,3,2012,0,0,0,0,32,7,25,3.5714285714285716,0,32
OMA,Oman,5,2016,0,0,0,0,4,2,2,1.0,0,4
AUT,Austria-1,4,2014,2,0,2,0,2,0,2,0.0,2,0
CUB,Cuba,3,2012,14,5,3,6,118,48,70,1.4583333333333333,14,104
NCA,Nicaragua,3,2012,0,0,0,0,6,3,3,1.0,0,6
RSA,South Africa,1,2008,1,0,1,0,179,80,99,1.2375,1,178
NGR,Nigeria,1,2008,23,0,16,7,89,47,42,0.8936170212765957,23,66
KAZ,Kazakhstan,1,2008,13,2,4,7,146,74,72,0.972972972972973,13,133
PNG,Papua New Guinea,1,2008,0,0,0,0,9,4,5,1.25,0,9
NCA,Nicaragua,1,2008,0,0,0,0,7,3,4,1.3333333333333333,0,7
NOR,Norway-1,1,2008,0,0,0,0,2,2,0,0.0,0,2
CZE,Czech Republic-2,1,2008,0,0,0,0,4,2,2,1.0,0,4
KGZ,Kyrgyzstan,1,2008,2,0,1,1,22,4,18,4.5,2,20
GUM,Guam,1,2008,0,0,0,0,7,2,5,2.5,0,7
NED,Netherlands-1,1,2008,0,0,0,0,2,0,2,0.0,0,2
NOR,Norway,1,2008,22,16,5,1,98,55,43,0.7818181818181819,22,76
NAM,Namibia,1,2008,0,0,0,0,11,5,6,1.2,0,11
NRU,Nauru,1,2008,0,0,0,0,1,0,1,0.0,0,1
AFG,Afghanistan,1,2008,1,0,0,1,4,1,3,3.0,1,3
VIE,Vietnam,1,2008,1,0,1,0,18,10,8,0.8,1,17
SMR,San Marino,1,2008,0,0,0,0,4,2,2,1.0,0,4
CUB,Cuba-2,1,2008,0,0,0,0,2,2,0,0.0,0,2
BEN,Benin,1,2008,0,0,0,0,5,2,3,1.5,0,5
COL,Colombia,1,2008,2,0,1,1,90,33,57,1.7272727272727273,2,88
ZAM,Zambia,1,2008,0,0,0,0,8,2,6,3.0,0,8
IRI,Iran,1,2008,2,1,0,1,55,3,52,17.333333333333332,2,53
LUX,Luxembourg,1,2008,0,0,0,0,19,4,15,3.75,0,19
IVB,British Virgin Islands,1,2008,0,0,0,0,2,1,1,1.0,0,2
USA,Mythilus,1,2008,0,0,0,0,1,1,0,0.0,0,1
BRA,Brazil-2,1,2008,2,0,0,2,4,2,2,1.0,2,2
POL,Poland,1,2008,20,6,13,1,312,131,181,1.381679389312977,20,292
ISR,Israel,1,2008,1,0,0,1,60,25,35,1.4,1,59
BRA,Brazil-1,1,2008,2,0,2,0,4,2,2,1.0,2,2
ISV,United States Virgin Islands,1,2008,0,0,0,0,8,2,6,3.0,0,8
GER,Satchmo,1,2008,1,1,0,0,1,1,0,0.0,1,0
DEN,Denmark-2,1,2008,0,0,0,0,2,0,2,0.0,0,2
GAB,Gabon,1,2008,0,0,0,0,4,2,2,1.0,0,4
OMA,Oman,1,2008,0,0,0,0,4,1,3,3.0,0,4
PAN,Panama,1,2008,1,1,0,0,5,2,3,1.5,1,4
ANG,Angola,1,2008,0,0,0,0,33,15,18,1.2,0,33
TLS,Timor Leste,1,2008,0,0,0,0,1,1,0,0.0,0,1
SUI,Switzerland-2,1,2008,0,0,0,0,2,0,2,0.0,0,2
POL,Poland-2,1,2008,0,0,0,0,2,2,0,0.0,0,2
JAM,Jamaica,1,2008,14,5,3,6,66,36,30,0.8333333333333334,14,52
UKR,Ukraine-2,1,2008,0,0,0,0,2,2,0,0.0,0,2
UGA,Uganda,1,2008,0,0,0,0,11,2,9,4.5,0,11
SYR,Syria,1,2008,0,0,0,0,7,1,6,6.0,0,7
AUT,Austria,1,2008,3,0,1,2,89,38,51,1.3421052631578947,3,86
CAN,Pop Art,1,2008,0,0,0,0,1,1,0,0.0,0,1
VEN,Venezuela,1,2008,1,0,0,1,126,58,68,1.1724137931034482,1,125
CRO,Croatia,1,2008,5,0,2,3,125,30,95,3.1666666666666665,5,120
YEM,Yemen,1,2008,0,0,0,0,8,1,7,7.0,0,8
RSA,South Africa,2,2010,0,0,0,0,2,0,2,0.0,0,2
DOM,Dominican Republic,1,2008,2,1,1,0,27,8,19,2.375,2,25
NEP,Nepal,1,2008,0,0,0,0,8,4,4,1.0,0,8
COK,Cook Islands,1,2008,0,0,0,0,4,1,3,3.0,0,4
COM,Comoros,1,2008,0,0,0,0,3,1,2,2.0,0,3
GBR,Lucky Star,1,2008,0,0,0,0,1,1,0,0.0,0,1
DEN,Don Schufro,1,2008,1,0,0,1,1,0,1,0.0,1,0
FRA,France-1,1,2008,0,0,0,0,2,0,2,0.0,0,2
DEN,Denmark-1,1,2008,0,0,0,0,2,0,2,0.0,0,2
RWA,Rwanda,1,2008,0,0,0,0,4,2,2,1.0,0,4
CHN,China-3,1,2008,0,0,0,0,2,2,0,0.0,0,2
AUS,Australia,1,2008,149,31,42,76,559,265,294,1.109433962264151,149,410
GHA,Ghana,2,2010,0,0,0,0,1,0,1,0.0,0,1
CHA,Chad,1,2008,0,0,0,0,2,1,1,1.0,0,2
BRN,Bahrain,1,2008,0,0,0,0,15,3,12,4.0,0,15
GEO,Georgia,1,2008,6,3,0,3,38,9,29,3.2222222222222223,6,32
IRQ,Iraq,1,2008,0,0,0,0,4,1,3,3.0,0,4
BLR,Belarus-1,1,2008,0,0,0,0,2,2,0,0.0,0,2
KUW,Kuwait,1,2008,0,0,0,0,8,0,8,0.0,0,8
MTN,Mauritania,1,2008,0,0,0,0,2,1,1,1.0,0,2
PER,Peru,1,2008,0,0,0,0,13,6,7,1.1666666666666667,0,13
UKR,Ukraine-1,1,2008,0,0,0,0,2,2,0,0.0,0,2
RUS,Russia-1,1,2008,0,0,0,0,4,2,2,1.0,0,4
BEL,Belgium,1,2008,5,1,4,0,112,22,90,4.090909090909091,5,107
FRA,Whitini Star,1,2008,0,0,0,0,1,0,1,0.0,0,1
GBR,Great Britain,1,2008,81,31,25,25,413,204,209,1.0245098039215685,81,332
DMA,Dominica,1,2008,0,0,0,0,2,0,2,0.0,0,2
AUT,Austria-2,1,2008,0,0,0,0,2,0,2,0.0,0,2
MKD,Macedonia,1,2008,0,0,0,0,7,2,5,2.5,0,7
MOZ,Mozambique,1,2008,0,0,0,0,4,2,2,1.0,0,4
SUI,Switzerland-1,1,2008,0,0,0,0,2,0,2,0.0,0,2
ARG,Argentina,1,2008,51,20,0,31,141,56,85,1.5178571428571428,51,90
BLR,Belarus-2,1,2008,0,0,0,0,2,2,0,0.0,0,2
CAN,Gran Gesto,1,2008,0,0,0,0,1,1,0,0.0,0,1
CHI,Chile,2,2010,0,0,0,0,10,5,5,1.0,0,10
ANT,Antigua and Barbuda,1,2008,0,0,0,0,5,1,4,4.0,0,5
HON,Honduras,1,2008,0,0,0,0,26,2,24,12.0,0,26
MHL,Marshall Islands,1,2008,0,0,0,0,5,2,3,1.5,0,5
CHN,China-2,2,2010,2,0,2,0,2,1,1,1.0,2,0
ALG,Algeria,1,2008,2,0,1,1,57,22,35,1.5909090909090908,2,55
MAS,Malaysia-2,1,2008,0,0,0,0,2,0,2,0.0,0,2
CRC,Costa Rica,1,2008,0,0,0,0,8,2,6,3.0,0,8
FRA,Diabolo St Maurice,1,2008,0,0,0,0,1,0,1,0.0,0,1
SMR,San Marino,2,2010,0,0,0,0,1,0,1,0.0,0,1
SVK,Slovakia,1,2008,10,4,5,1,67,28,39,1.3928571428571428,10,57
INA,Indonesia,1,2008,3,0,0,3,18,9,9,1.0,3,15
GER,Bonaparte,1,2008,1,1,0,0,1,1,0,0.0,1,0
PLW,Palau,1,2008,0,0,0,0,5,2,3,1.5,0,5
KIR,Kiribati,1,2008,0,0,0,0,2,0,2,0.0,0,2
THA,Thailand,1,2008,4,2,2,0,53,30,23,0.7666666666666667,4,49
AHO,Netherlands Antilles,1,2008,0,0,0,0,4,0,4,0.0,0,4
TPE,Chinese Taipei,2,2010,0,0,0,0,1,0,1,0.0,0,1
PRK,North Korea,1,2008,6,2,1,3,66,44,22,0.5,6,60
DEN,Clearwater,1,2008,1,0,0,1,1,1,0,0.0,1,0
SWE,Sweden-1,1,2008,0,0,0,0,2,0,2,0.0,0,2
KSA,Saudi Arabia,1,2008,0,0,0,0,18,0,18,0.0,0,18
ARU,Aruba,1,2008,0,0,0,0,2,0,2,0.0,0,2
MLI,Mali,1,2008,0,0,0,0,17,14,3,0.21428571428571427,0,17
AUS,Relampago,1,2008,0,0,0,0,1,1,0,0.0,0,1
NED,Salinero,1,2008,1,0,1,0,1,1,0,0.0,1,0
UKR,Ukraine-2,2,2010,0,0,0,0,4,1,3,3.0,0,4
ROU,Romania,1,2008,22,5,1,16,172,88,84,0.9545454545454546,22,150
FRA,France,1,2008,77,25,24,28,441,181,260,1.4364640883977902,77,364
FSM,Federated States of Micronesia,1,2008,0,0,0,0,5,2,3,1.5,0,5
ALB,Albania,1,2008,0,0,0,0,12,5,7,1.4,0,12
DJI,Djibouti,1,2008,0,0,0,0,2,1,1,1.0,0,2
DEN,Digby,1,2008,1,0,0,1,1,1,0,0.0,1,0
PAK,Pakistan,2,2010,0,0,0,0,1,0,1,0.0,0,1
ERI,Eritrea,1,2008,0,0,0,0,11,2,9,4.5,0,11
MAW,Malawi,1,2008,0,0,0,0,4,2,2,1.0,0,4
BAR,Barbados,1,2008,0,0,0,0,10,2,8,4.0,0,10
POR,Oxalis,1,2008,0,0,0,0,1,0,1,0.0,0,1
SRI,Sri Lanka,1,2008,0,0,0,0,9,4,5,1.25,0,9
FIJ,Fiji,1,2008,0,0,0,0,6,2,4,2.0,0,6
NIG,Niger,1,2008,0,0,0,0,4,2,2,1.0,0,4
GBR,Lancet,1,2008,0,0,0,0,1,1,0,0.0,0,1
HAI,Haiti,1,2008,0,0,0,0,7,4,3,0.75,0,7
LIB,Lebanon,1,2008,0,0,0,0,6,2,4,2.0,0,6
JPN,Rambo,1,2008,0,0,0,0,1,1,0,0.0,0,1
CUB,Cuba,1,2008,47,2,34,11,167,57,110,1.9298245614035088,47,120
FIN,Finland,1,2008,5,1,2,2,70,32,38,1.1875,5,65
IRL,Ireland,1,2008,3,0,1,2,63,19,44,2.3157894736842106,3,60
BIZ,Belize,1,2008,0,0,0,0,4,1,3,3.0,0,4
USA,Brentina,1,2008,0,0,0,0,1,1,0,0.0,0,1
GUI,Guinea,1,2008,0,0,0,0,5,3,2,0.6666666666666666,0,5
GBR,Great Britain-1,1,2008,0,0,0,0,2,1,1,1.0,0,2
MAD,Madagascar,1,2008,0,0,0,0,6,2,4,2.0,0,6
SWE,Solos Carex,1,2008,0,0,0,0,1,1,0,0.0,0,1
SEY,Seychelles,1,2008,0,0,0,0,10,3,7,2.3333333333333335,0,10
CHN,China-1,1,2008,10,2,4,4,10,7,3,0.42857142857142855,10,0
MON,Monaco,1,2008,0,0,0,0,5,1,4,4.0,0,5
GBR,Mistral Hojris,1,2008,0,0,0,0,1,1,0,0.0,0,1
MAR,Morocco,2,2010,0,0,0,0,2,0,2,0.0,0,2
GRE,Greece,1,2008,7,0,3,4,172,75,97,1.2933333333333332,7,165
TUV,Tuvalu,1,2008,0,0,0,0,3,1,2,2.0,0,3
SUR,Suriname,1,2008,0,0,0,0,4,2,2,1.0,0,4
GBR,Great Britain-2,1,2008,0,0,0,0,2,1,1,1.0,0,2
CHN,China-1,2,2010,2,2,0,0,2,1,1,1.0,2,0
SWE,Floresco,1,2008,0,0,0,0,1,0,1,0.0,0,1
MEX,Mexico,1,2008,4,2,0,2,103,51,52,1.0196078431372548,4,99
CIV,Cote d'Ivoire,1,2008,0,0,0,0,22,2,20,10.0,0,22
MDV,Maldives,1,2008,0,0,0,0,4,2,2,1.0,0,4
KOR,South Korea,1,2008,72,39,9,24,317,115,202,1.7565217391304349,72,245
CAN,Orion,1,2008,0,0,0,0,1,1,0,0.0,0,1
ASA,American Samoa,1,2008,0,0,0,0,4,2,2,1.0,0,4
BOT,Botswana,1,2008,0,0,0,0,11,2,9,4.5,0,11
MAS,Malaysia,1,2008,1,0,1,0,38,16,22,1.375,1,37
BLR,Belarus,1,2008,29,8,5,16,233,92,141,1.5326086956521738,29,204
CYP,Cyprus,1,2008,0,0,0,0,18,11,7,0.6363636363636364,0,18
LCA,Saint Lucia,1,2008,0,0,0,0,4,3,1,0.3333333333333333,0,4
NED,Netherlands,1,2008,58,39,15,4,276,121,155,1.28099173553719,58,218
CAM,Cambodia,1,2008,0,0,0,0,4,2,2,1.0,0,4
GER,Elvis Va,1,2008,1,1,0,0,1,1,0,0.0,1,0
IND,India,1,2008,3,1,0,2,67,29,38,1.3103448275862069,3,64
ETH,Ethiopia,1,2008,7,4,1,2,29,14,15,1.0714285714285714,7,22
CZE,Czech Republic-1,1,2008,0,0,0,0,4,2,2,1.0,0,4
SRB,Serbia,1,2008,15,0,1,14,97,27,70,2.5925925925925926,15,82
TGA,Tonga,1,2008,0,0,0,0,3,1,2,2.0,0,3
TAN,Tanzania,1,2008,0,0,0,0,9,2,7,3.5,0,9
SLO,Slovenia,1,2008,5,1,2,2,73,27,46,1.7037037037037037,5,68
ISL,Iceland,1,2008,14,0,14,0,31,9,22,2.4444444444444446,14,17
ITA,Italy-1,1,2008,0,0,0,0,2,2,0,0.0,0,2
FRA,France-2,1,2008,0,0,0,0,2,0,2,0.0,0,2
POL,Poland-1,1,2008,0,0,0,0,2,2,0,0.0,0,2
SUI,Switzerland,1,2008,11,3,1,7,112,48,64,1.3333333333333333,11,101
LAT,Latvia,1,2008,3,1,1,1,53,18,35,1.9444444444444444,3,50
COD,Congo (Kinshasa),1,2008,0,0,0,0,5,1,4,4.0,0,5
CGO,Congo (Brazzaville),1,2008,0,0,0,0,5,2,3,1.5,0,5
USA,United States-2,1,2008,2,2,0,0,8,4,4,1.0,2,6
PER,Peru,2,2010,0,0,0,0,5,2,3,1.5,0,5
GBS,Guinea Bissau,1,2008,0,0,0,0,3,1,2,2.0,0,3
CMR,Cameroon,1,2008,1,1,0,0,32,7,25,3.5714285714285716,1,31
CHN,China,1,2008,170,72,49,49,708,338,370,1.0946745562130178,170,538
BUR,Burkina Faso,1,2008,0,0,0,0,6,3,3,1.0,0,6
CPV,Cape Verde,1,2008,0,0,0,0,2,1,1,1.0,0,2
HKG,Hong Kong,1,2008,0,0,0,0,47,25,22,0.88,0,47
SOM,Somalia,1,2008,0,0,0,0,2,1,1,1.0,0,2
BDI,Burundi,1,2008,0,0,0,0,3,2,1,0.5,0,3
LIE,Liechtenstein,1,2008,0,0,0,0,2,0,2,0.0,0,2
PRK,North Korea,2,2010,0,0,0,0,3,2,1,0.5,0,3
BRA,Brazil,1,2008,74,14,32,28,330,162,168,1.037037037037037,74,256
LES,Lesotho,1,2008,0,0,0,0,5,1,4,4.0,0,5
INA,Indonesia-1,1,2008,4,2,2,0,4,1,3,3.0,4,0
JPN,Japan-2,1,2008,0,0,0,0,4,2,2,1.0,0,4
AND,Andorra,1,2008,0,0,0,0,5,2,3,1.5,0,5
VIN,Saint Vincent and the Grenadines,1,2008,0,0,0,0,2,1,1,1.0,0,2
SEN,Senegal,2,2010,0,0,0,0,2,0,2,0.0,0,2
SWE,Sweden,1,2008,5,0,3,2,162,96,66,0.6875,5,157
CHN,China-2,1,2008,4,0,0,4,10,7,3,0.42857142857142855,4,6
ESP,Spain-1,1,2008,2,0,2,0,4,2,2,1.0,2,2
GAM,Gambia,1,2008,0,0,0,0,3,1,2,2.0,0,3
NED,Sunrise,1,2008,1,0,1,0,1,1,0,0.0,1,0
BHU,Bhutan,1,2008,0,0,0,0,2,1,1,1.0,0,2
KEN,Kenya,1,2008,15,6,4,5,47,18,29,1.6111111111111112,15,32
JPN,Whisper,1,2008,0,0,0,0,1,0,1,0.0,0,1
GRN,Grenada,1,2008,0,0,0,0,9,5,4,0.8,0,9
INA,Indonesia-2,1,2008,0,0,0,0,4,1,3,3.0,0,4
MAS,Malaysia-1,1,2008,0,0,0,0,2,0,2,0.0,0,2
USA,United States,1,2008,309,121,110,78,744,356,388,1.0898876404494382,309,435
KOR,South Korea-2,1,2008,0,0,0,0,6,3,3,1.0,0,6
AZE,Azerbaijan,1,2008,7,1,2,4,44,14,30,2.142857142857143,7,37
LBA,Libya,1,2008,0,0,0,0,6,2,4,2.0,0,6
USA,Ravel,1,2008,0,0,0,0,1,0,1,0.0,0,1
TOG,Togo,1,2008,1,0,0,1,4,1,3,3.0,1,3
SOL,Solomon Islands,1,2008,0,0,0,0,3,2,1,0.5,0,3
GER,Germany,1,2008,96,39,16,41,547,238,309,1.2983193277310925,96,451
PUR,Puerto Rico,1,2008,0,0,0,0,31,7,24,3.4285714285714284,0,31
ESP,Spain-2,1,2008,0,0,0,0,4,2,2,1.0,0,4
EST,Estonia,1,2008,3,1,2,0,53,17,36,2.1176470588235294,3,50
PLE,Palestine,1,2008,0,0,0,0,4,2,2,1.0,0,4
ECU,Ecuador,1,2008,1,0,1,0,26,8,18,2.25,1,25
GER,Germany-2,1,2008,0,0,0,0,4,2,2,1.0,0,4
KOR,South Korea-1,1,2008,6,2,2,2,6,3,3,1.0,6,0
ZIM,Zimbabwe,1,2008,4,1,3,0,16,8,8,1.0,4,12
CUB,Cuba-1,1,2008,0,0,0,0,2,2,0,0.0,0,2
ARG,Argentina-1,1,2008,0,0,0,0,2,0,2,0.0,0,2
PHI,Philippines,1,2008,0,0,0,0,17,6,11,1.8333333333333333,0,17
LAO,Laos,1,2008,0,0,0,0,4,2,2,1.0,0,4
ARG,Argentina-2,1,2008,0,0,0,0,2,0,2,0.0,0,2
LIE,Liechtenstein,2,2010,0,0,0,0,5,1,4,4.0,0,5
DEN,Denmark,1,2008,16,6,7,3,101,30,71,2.3666666666666667,16,85
USA,United States-1,1,2008,6,4,0,2,8,4,4,1.0,6,2
ESP,Spain,1,2008,68,7,45,16,347,142,205,1.443661971830986,68,279
NED,Netherlands-2,1,2008,0,0,0,0,2,0,2,0.0,0,2
UAE,United Arab Emirates,1,2008,0,0,0,0,9,2,7,3.5,0,9
GER,Germany-1,1,2008,0,0,0,0,4,2,2,1.0,0,4
MLT,Malta,1,2008,0,0,0,0,6,3,3,1.0,0,6
MRI,Mauritius,1,2008,1,0,0,1,11,5,6,1.2,1,10
AUS,Australia-2,1,2008,0,0,0,0,4,2,2,1.0,0,4
SAM,Samoa,1,2008,0,0,0,0,7,2,5,2.5,0,7
VAN,Vanuatu,1,2008,0,0,0,0,3,2,1,0.5,0,3
GRE,Greece-2,1,2008,0,0,0,0,2,2,0,0.0,0,2
NZL,New Zealand,1,2008,15,4,2,9,201,89,112,1.2584269662921348,15,186
MYA,Myanmar,1,2008,0,0,0,0,7,2,5,2.5,0,7
SUD,Sudan,1,2008,1,0,1,0,9,4,5,1.25,1,8
SEN,Senegal,1,2008,0,0,0,0,17,7,10,1.4285714285714286,0,17
RUS,Russia-2,1,2008,0,0,0,0,4,2,2,1.0,0,4
POR,Galopin De La Font,1,2008,0,0,0,0,1,0,1,0.0,0,1
ITA,Italy-2,1,2008,0,0,0,0,2,2,0,0.0,0,2
MDA,Moldova,1,2008,1,0,0,1,30,8,22,2.75,1,29
TUR,Turkey,1,2008,7,1,3,3,71,21,50,2.380952380952381,7,64
QAT,Qatar,1,2008,0,0,0,0,20,0,20,0.0,0,20
FRA,Calimucho,1,2008,0,0,0,0,1,1,0,0.0,0,1
CAF,Central African Republic,1,2008,0,0,0,0,3,1,2,2.0,0,3
TUN,Tunisia,1,2008,1,1,0,0,29,12,17,1.4166666666666667,1,28
ITA,Italy,1,2008,42,8,14,20,455,179,276,1.541899441340782,42,413
MGL,Mongolia,1,2008,4,2,2,0,31,17,14,0.8235294117647058,4,27
TPE,Chinese Taipei,1,2008,4,0,0,4,92,44,48,1.0909090909090908,4,88
MAR,Morocco,1,2008,2,0,1,1,49,12,37,3.0833333333333335,2,47
ARM,Armenia,1,2008,6,0,0,6,26,2,24,12.0,6,20
SLE,Sierra Leone,1,2008,0,0,0,0,3,1,2,2.0,0,3
JPN,Japan,1,2008,51,23,15,13,446,218,228,1.0458715596330275,51,395
GUA,Guatemala,1,2008,0,0,0,0,13,4,9,2.25,0,13
UKR,Ukraine,1,2008,31,10,5,16,323,162,161,0.9938271604938271,31,292
CAY,Cayman Islands,1,2008,0,0,0,0,6,1,5,5.0,0,6
AUS,Greenoaks Dundee,1,2008,0,0,0,0,1,0,1,0.0,0,1
POR,Portugal,1,2008,2,1,1,0,84,29,55,1.896551724137931,2,82
PAK,Pakistan,1,2008,0,0,0,0,22,2,20,10.0,0,22
JPN,Japan-1,1,2008,0,0,0,0,4,2,2,1.0,0,4
TKM,Turkmenistan,1,2008,0,0,0,0,10,4,6,1.5,0,10
BAN,Bangladesh,1,2008,0,0,0,0,5,2,3,1.5,0,5
BUL,Bulgaria,1,2008,5,1,1,3,87,35,52,1.4857142857142858,5,82
BAH,Bahamas,1,2008,7,0,6,1,33,11,22,2.0,7,26
GEQ,Equatorial Guinea,1,2008,0,0,0,0,3,1,2,2.0,0,3
UZB,Uzbekistan,1,2008,6,1,2,3,69,20,49,2.45,6,63
EGY,Egypt,1,2008,1,0,0,1,116,34,82,2.411764705882353,1,115
URU,Uruguay,1,2008,0,0,0,0,13,3,10,3.3333333333333335,0,13
NED,Nadine,1,2008,1,0,1,0,1,0,1,0.0,1,0
CHN,China-3,2,2010,0,0,0,0,2,1,1,1.0,0,2
LTU,Lithuania,1,2008,5,0,2,3,78,33,45,1.3636363636363635,5,73
CAN,Canada,1,2008,35,11,13,11,446,185,261,1.4108108108108108,35,411
JOR,Jordan,1,2008,0,0,0,0,7,4,3,0.75,0,7
SGP,Singapore,1,2008,3,0,3,0,36,23,13,0.5652173913043478,3,33
ETH,Ethiopia,2,2010,0,0,0,0,1,0,1,0.0,0,1
SWZ,Swaziland,1,2008,0,0,0,0,4,2,2,1.0,0,4
STP,Sao Tome and Principe,1,2008,0,0,0,0,4,1,3,3.0,0,4
CZE,Czech Republic,1,2008,7,3,4,0,150,67,83,1.2388059701492538,7,143
SKN,Saint Kitts and Nevis,1,2008,0,0,0,0,6,4,2,0.5,0,6
LBR,Liberia,1,2008,0,0,0,0,4,2,2,1.0,0,4
GBR,Great Britain-2,2,2010,0,0,0,0,4,3,1,0.3333333333333333,0,4
AUT,Austria-1,1,2008,0,0,0,0,2,0,2,0.0,0,2
AUS,Quando Quando,1,2008,0,0,0,0,1,1,0,0.0,0,1
JPN,Dow Jones,1,2008,0,0,0,0,1,1,0,0.0,0,1
BER,Bermuda,2,2010,0,0,0,0,1,0,1,0.0,0,1
GUY,Guyana,1,2008,0,0,0,0,4,2,2,1.0,0,4
MNE,Montenegro,1,2008,0,0,0,0,20,2,18,9.0,0,20
BIH,Bosnia and Herzegovina,1,2008,0,0,0,0,7,1,6,6.0,0,7
SWE,Sweden-2,1,2008,2,0,2,0,2,0,2,0.0,2,0
PAR,Paraguay,1,2008,0,0,0,0,7,4,3,0.75,0,7
NOR,Norway-2,1,2008,0,0,0,0,2,2,0,0.0,0,2
TTO,Trinidad and Tobago,1,2008,6,5,1,0,35,13,22,1.6923076923076923,6,29
RUS,Russia,1,2008,142,43,46,53,592,281,311,1.106761565836299,142,450
AUS,Australia-1,1,2008,0,0,0,0,4,2,2,1.0,0,4
ALG,Algeria,2,2010,0,0,0,0,1,0,1,0.0,0,1
TJK,Tajikistan,1,2008,2,0,1,1,16,3,13,4.333333333333333,2,14
GHA,Ghana,1,2008,0,0,0,0,9,1,8,8.0,0,9
HUN,Hungary,1,2008,27,16,8,3,216,103,113,1.0970873786407767,27,189
BER,Bermuda,1,2008,0,0,0,0,6,4,2,0.5,0,6
BOL,Bolivia,1,2008,0,0,0,0,7,3,4,1.3333333333333333,0,7
GRE,Greece-1,1,2008,0,0,0,0,2,2,0,0.0,0,2
ESA,El Salvador,1,2008,0,0,0,0,14,10,4,0.4,0,14
CHI,Chile,1,2008,1,0,1,0,29,7,22,3.142857142857143,1,28
LAT,Latvia-2,2,2010,0,0,0,0,2,0,2,0.0,0,2
POR,Notavel,1,2008,0,0,0,0,1,0,1,0.0,0,1
SWE,Briar,1,2008,0,0,0,0,1,0,1,0.0,0,1
